＃＃＃＃＃＃＃＃＃＃＃＃＃＃＃＃＃＃＃＃
＃　　　　　　　　　　　　　　　　　　＃
＃　　　　　　　　　　　　　　　　　　＃
＃　　　　　　　　　　　　　　　　　　＃
＃　　　　　　　　　　　　　　　　　　＃
＃　　　　　　　　　　　　　　　　　　＃
＃　　　　　＃＃＃　＃＃＃　　　　　　＃
＃　　　　　＃　　　　　＃　　　　　　＃
＃　　　　　＃　　＠　　＃　　　　　　＃
＃＃＃＃＃＃＃＃＃＃＃＃＃＃＃＃＃＃＃＃