10,20
####################
#                  #
#                  #
#                  #
#                  #
#                  #
#     ### ###      #
#     #     #      #
#     #  @  #      #
####################