10,20
####################
#                  #
#                  #
#                  #
#        @         #
#     ###  ##      #
#     #     #      #
#     #     #      #
#     #     #      #
####################